11111111111111111111111140031111111111111111111111111
11111111111111111111111140031111111111111111111111111
11111111111111111111111140031111111111111111111111111
11111111111111111111111140031111111111111111111111111
11111111111111111111111140031111111111111111111111111
11111111111111111111111140031111111111111111111111111
11111111111111111111111140031111111111111111111111111
11111111111111111111111140031111111111111111111111111
11111111111111111111111140031111111111111111111111111
11111111111111111111111140031111111111111111111111111
11111111111111111111111140031111111111111111111111111
11111111111111111111111140031111111111111111111111111
11111111111111111111111140031111111111111111111111111
66666666666666666666666680076666666666666666666666666
00000000000000000000000000000000000000000000000000000
00000000000000000000000000000000000000000000000000000
55555555555555555555555590025555555555555555555555555
11111111111111111111111140031111111111111111111111111
11111111111111111111111140031111111111111111111111111
11111111111111111111111140031111111111111111111111111
11111111111111111111111140031111111111111111111111111
11111111111111111111111140031111111111111111111111111
11111111111111111111111140031111111111111111111111111
11111111111111111111111140031111111111111111111111111
11111111111111111111111140031111111111111111111111111
11111111111111111111111140031111111111111111111111111
11111111111111111111111140031111111111111111111111111
11111111111111111111111140031111111111111111111111111
11111111111111111111111140031111111111111111111111111
11111111111111111111111140031111111111111111111111111
-
0,24,13
1,7,9
1,19,6
1,29,10
1,50,28
1,49,20
1,20,20
1,14,25
1,28,40
2,6,0